(---------------------------------------------------------------------)
(                                                                     )
(    QUICKPLACE LOG                                                   )
(                                                                     )
(    Drawing          : Stereo.brd                                    )
(    Software Version : 16.6P004                                      )
(    Date/Time        : Sat Oct 11 15:21:17 2014                      )
(                                                                     )
(---------------------------------------------------------------------)


